111101111
10E000001
10P000001
10C0000H1
111111111