111111111
10E000001
10P000001
10C000H01
111111111