111111111
100PEC001
100000001
111111111