1111111111111111111
1000000000000C00001
1000E00C0000CPC0001
1000H00000000C00001
1111111111111111111